C 161,181,234
F 228,0,80

NO ./includes/textures/purplecosmos.xpm
SO ./includes/textures/pinkcosmos.xpm
WE ./includes/textures/greycosmos.xpm
EA ./includes/textures/yellcosmos.xpm

 1111111111111111111111111111111111
10000000000000000000000000000000001
100000000010000000000000000000000001
100N00000010000000000001000000000001
100000000000000001100000000000000001
100000000000000000000000000000000001
 10000000111111111111111111111111111
 111111001
     1001
     1001
     1111
