NO ./includes/textures/norregerhgth.xpm
SO ./includes/textures/souheherheth.xpm
WE ./includes/textures/wghgfhfgest.xpm
EA ./includes/textures/ejfghjfgjast.xpm

F 220,100,0
C 225,30,0

  111111
1000000001
1000010001
1000000001
1000010001
100N010001
 1000000011
1111110011
     1001
     1001
     1111